D:/VSProb/TEST_SFML/data/img/Textures_v02.png
5,5 5,5 5,5 5,5 5,5 5,5 5,5 5,5 5,5 5,5
5,5 5,5 5,5 5,5 5,5 5,5 5,5 5,5 5,5 5,5
5,5 5,5 5,5 5,5 5,5 5,5 5,5 5,5 5,5 5,5
5,5 5,5 5,5 5,5 5,5 5,5 5,5 5,5 5,5 5,5
x,x x,x x,x x,x x,x x,x x,x x,x x,x x,x
5,4 5,4 5,4 5,4 5,4 5,4 5,4 5,4 5,4 5,4
4,4 4,4 4,4 4,4 4,4 4,4 4,4 4,4 4,4 4,4
0,3 0,3 0,3 0,3 0,3 0,3 0,3 0,3 0,3 0,3
5,5 5,5 5,5 5,5 5,5 5,5 5,5 5,5 5,5 5,5 5,5 5,5 5,5 5,5 5,5 5,5 5,5 5,5 5,5 5,5
5,5 5,5 5,5 5,5 5,5 5,5 5,5 5,5 5,5 5,5 5,5 5,5 5,5 5,5 5,5 5,5 5,5 5,5 5,5 5,5
2,8 2,8 2,8 2,8 2,8 2,8 2,8 2,8 2,8 2,8 2,8 2,8 2,8 2,8 2,8 2,8 2,8 2,8 2,8 2,8
2,8 2,8 2,8 2,8 2,8 2,8 2,8 2,8 2,8 2,8 2,8 2,8 2,8 2,8 2,8 2,8 2,8 2,8 2,8 2,8
2,8 2,8 2,8 2,8 2,8 2,8 2,8 2,8 2,8 2,8 2,8 2,8 2,8 2,8 2,8 2,8 2,8 2,8 2,8 2,8
2,8 2,8 2,8 2,8 2,8 2,8 2,8 2,8 2,8 2,8 2,8 2,8 2,8 2,8 2,8 2,8 2,8 2,8 2,8 2,8